0:5:120:5
1:10:50:8
2:3:30:20
1:5:10:10
2:15:20
0:5:120:5